1111111111111111111111111111111111
1C1000C1P0000000000000000000000001
10101N0101000000000000000000000N01
10001C010100000000000000000000NC01
1E11110001000000000000000000000N01
1011111111111111111111111111111111
1010000100000000000000000000000001
101011N101111110000000000000000001
10001101010N0010000000000000000001
1010000001000010000000000000000001
1011111111111N10000000000000000001
100000000000001C0000000000000000C1
1111111111111111111111111111111111
