1111111111
1C1000C1P1
1010100101
10001C0101
1E11110001
1111111111
